052-021-038-023-029-000-059-064-052-022-033-089-073-090-027-093-098-058-021-067-078-999-071-011-075-056-044-018-008-095-065-015-016-079-055-007-019-074-051-050
000-000-000-000-000-000-000-000-000-000-000-000-000-000-000-000-000-000-000-000-000-000-000-000-000-000-000-000-000-000-000-000-000-000-000-000-000-000-000-000
000-000-000-000-000-000-000-000-000-000-000-000-000-000-000-000-000-000-000-000-000-000-000-000-000-000-000-000-000-000-000-000-000-000-000-000-000-000-000-000
072-023-034-013-087-000-093-056-084-094-008-043-014-038-065-071-066-088-020-092-045-077-037-074-000-032-018-007-033-000-040-091-011-022-029-027-048-025-082-070
090-066-022-049-004-000-082-096-016-085-098-030-011-048-055-029-031-019-039-006-056-059-064-042-000-092-083-062-013-000-074-025-017-084-089-041-037-060-010-061
000-000-000-000-000-000-083-056-057-073-097-086-010-078-089-047-070-079-027-076-024-092-046-042-000-999-043-017-008-011-039-005-049-053-007-025-020-034-037-035
035-097-062-065-080-000-067-007-014-004-085-082-087-071-093-054-057-084-018-061-072-023-053-041-000-025-040-066-076-999-096-036-078-047-088-042-026-034-051-070
028-034-059-011-099-000-076-098-068-014-064-043-078-053-035-086-018-058-009-006-095-077-026-094-000-032-074-097-038-000-085-004-049-041-091-081-093-013-036-075
044-075-014-019-038-000-089-094-051-035-066-049-048-007-053-006-054-999-090-047-087-068-025-067-000-015-045-065-080-000-041-056-029-037-010-077-004-074-088-057
032-034-052-096-074-000-007-025-081-012-005-016-076-071-043-004-035-039-050-029-011-019-036-060-000-062-080-059-067-000-045-015-084-024-999-041-061-054-042-075
077-012-025-028-092-000-017-058-048-043-021-039-086-044-041-004-093-060-040-074-007-073-052-049-000-068-096-029-085-000-081-082-098-999-999-050-023-999-999-019
058-033-019-005-015-000-061-037-065-016-095-096-093-007-077-050-024-091-070-004-031-085-999-063-000-047-072-999-999-000-999-073-029-999-999-999-056-999-999-999
077-061-033-018-081-000-054-043-087-093-091-026-004-014-056-068-006-063-030-044-083-079-059-092-000-999-999-999-999-000-999-999-999-999-999-999-999-999-086-999
026-078-093-087-042-000-056-999-063-089-031-017-092-029-021-028-052-088-085-091-020-018-068-009-000-999-999-999-012-999-999-999-999-999-035-999-999-099-066-059
006-068-038-081-027-000-035-095-058-087-043-051-007-084-036-071-017-010-031-039-098-999-090-045-999-999-999-088-999-999-999-053-999-999-062-054-074-072-019-040
035-034-033-009-060-000-051-025-096-068-057-083-043-044-004-010-007-054-065-077-075-999-999-999-999-999-999-999-999-000-082-080-037-090-091-063-052-093-056-078
095-063-029-032-090-000-012-037-047-045-009-046-059-010-083-015-022-049-058-093-038-050-082-999-999-036-020-041-043-000-055-044-068-035-025-007-076-064-084-018
090-051-006-047-007-000-068-045-024-095-039-022-041-018-065-060-092-049-094-036-066-086-023-055-000-015-033-038-025-000-093-053-059-056-085-084-011-081-082-031
005-030-032-021-033-000-036-004-026-080-090-013-025-098-010-077-037-073-056-052-097-027-089-078-000-009-096-012-040-000-063-007-042-083-060-048-018-016-004-039
015-035-050-076-088-000-029-052-005-028-026-084-030-012-053-083-064-044-999-086-082-007-051-078-000-094-079-042-041-000-068-077-025-021-081-060-022-063-071-004
006-063-999-999-099-000-032-075-098-087-089-085-088-081-064-047-024-013-034-049-069-999-078-030-000-092-073-056-017-000-052-059-015-076-045-079-080-044-068-037
999-999-999-999-999-999-999-021-022-017-023-074-071-009-065-049-046-095-020-057-068-999-088-062-000-083-031-082-087-000-010-016-085-098-091-047-079-012-072-067
038-999-083-999-056-999-071-087-084-073-028-060-076-069-074-055-050-092-027-047-022-094-005-031-000-008-044-093-017-000-034-066-033-097-029-016-061-089-030-091
007-054-081-095-049-000-098-040-034-097-076-038-024-048-058-013-089-026-062-083-080-061-005-077-000-074-072-073-032-000-057-093-012-088-008-031-006-042-064-066
075-097-071-016-027-000-062-068-018-092-045-032-086-098-081-026-034-007-040-023-082-025-049-056-000-054-041-021-085-000-015-999-076-077-067-029-070-035-091-094
034-038-075-056-097-000-049-005-047-058-044-045-088-057-009-083-062-030-084-036-023-015-020-090-000-004-091-074-053-000-041-081-026-072-033-087-069-077-096-011
047-056-062-044-057-000-000-000-000-000-000-000-000-000-000-000-000-000-000-000-000-000-000-000-000-000-000-000-000-000-000-000-000-000-009-075-048-091-038-008
099-083-060-018-019-000-049-063-024-048-016-030-054-011-032-075-094-022-047-088-076-045-097-038-000-082-008-023-043-071-050-093-087-005-007-057-040-053-081-034
008-018-094-073-022-000-059-030-038-012-041-027-091-077-096-092-005-083-026-075-052-064-045-036-000-019-033-065-078-035-042-010-084-011-090-063-095-047-031-074
015-097-085-011-043-000-057-046-072-062-077-027-021-017-024-095-034-028-060-068-076-079-005-070-000-055-088-013-071-009-053-022-026-036-035-064-023-086-075-052